E E E E E E E E E E E E E E E E E E E E E E E E E E E E E E
N N N N N N N N E N N N N N N N N N N N N N N N N N N N N N
N N N N N N N N W N N N N N N N N N N N N N N N N N N N N N
N N N N c c x c c c c c C C V C C C C C C c v c c N N N N N
N N N N c N N N N N N N C N N N C N N N C N N N c N N N N N
N N N N c N N N N N N N H N N N H N N N H N N N c N N N N N
N N N N c N N N N N N N C N N N C N N N C N N N c N N N N N
N N N N C C V C C C V C C C V C C C V C C c v c c N N N N N
N N N N C N N N C N N N C N N N C N N N C N N N N N N N N N
N N N N H N N N H N N N H N N N H N N N H N N N N N N N N N
N N N N C N N N C N N N E N N N E N N N C N N N N N N N N N
E E 1 E C C V C C N N N E E B E E N N N C C V C C E 2 E E E
N N N N C N N N C N N N E N N N E N N N C N N N C N N N N N
N N N N H N N N H N N N F N N N F N N N H N N N H N N N N N
N N N N C N N N C N N N E N N N E N N N C N N N C N N N N N
N N 3 e C C V C C C V C C E L E C C V C C C V C C e 4 e N N
N N N N c N N N C N N N C N N N C N N N C N N N c N N N N N
N N N N h N N N H N N N H N N N H N N N H N N N h N N N N N
N N N N c N N N C N N N C N N N C N N N C N N N c N N N N N
N N N N c N N N C C V C C N N N C C V C C N N N c N N N N N
N N N N c N N N C N N N C N N N C N N N C N N N c N N N N N
N N N N c N N N H N N N H N N N H N N N H N N N c N N N N N
N N N N c N N N C N N N C N N N C N N N C N N N c N N N N N
N N N N c c v c C C V C C C C C C C V C C c v c c N N N N N
N N N N N N N N N N N N N N N N N N N N W N N N N N N N N N
N N N N N N N N N N N N N N N N N N N N E N N N N N N N N N
E E E E E E E E E E E E E E E E E E E E E E E E E E E E E E